###############################################
#                 #                 #       #
# ### ############# ### ############# ##### #
# #     #           #   # #         # #   # #
# ######### ####### ### # ####### # ##### # #
#       #   #       # #   #     # #     #   #
# ##### # # # ####### # ### # # # # ### # # #
# #   # # # #         #   #   # #   #     # #
# # # # # # ### ##### # ##### ### ##### # # #
# #   # #     #       #   #   # #   #   # # #
# # ### ######### ####### # ####### # ### # #
# #   #   #     #   #   # #   #   #   # #   #
# ### # # ##### # # ### # # ##### # ### # # #
#   #   #   #     # # # #     # # # #   # # #
######### # ##### # ##### # # # # ######### #
# # #           #     #   #   # #   #     # #
# # ##### ####### ########### ####### ##### #
#   # # #       #   #   #     # #   #       #
### # # # ####### # # # # ##### # ### ### # #
#   #   #   #     # # # #     # # # # #   # #
# ### ##### # ##### # ##### # # ### ### # # #
# # #   #     #   #   # # # #     # #   # # #
######### # ##### # # # # # # ##### # # ##### #
#           #     #   #   # #   #     #     # #
################# ######### # ############### #
#                             #                 #
###############################################
