# ###############################################
# #                 #                 #       # #
# ### ############# ### ############# # ##### # #
#     #           #   # #         # #   #   #   #
######### ####### ### # # ####### # ##### ##### #
#       #   #       # #   #     # #     #     # #
# ##### # # # ####### # ### ### # # ### # # # # #
# #   # # # #     #   # #   # #   # #   # # # # #
# # # # ### ##### # ##### ### ##### # ##### ### #
# # # #   # #     # #   #   # #     #     # #   #
# # # ### # # ##### # # ### # # # ####### # # ###
# # #   #   #     #   #   # #   #   #   # # #   #
# # ### ######### ####### # ####### # ### # ### #
# # #           #       #   #       #     # #   #
# # ##### ####### ########### ####### ##### # ###
# #   # # #       #   #   #   #     # #     #   #
# ### # # # ####### # # # # # ##### # # ### ### #
# #   #   #   #     # # # # #     # # # # #   # #
# # ######### # ##### # # # ##### # # # # ### # #
# #           #     #   #   # #   #     #     # #
# ################# ######### # ############### #
#                             #                 #
############################################### #